21111111110000000000
00000000010000111100
00011111110000100000
00010000010000100000
00010000011111111110
00010000000000100000
00010000000000111100
00011111110000100000
00000000010000000010
00000111111111110010
00000100000000010010
01111100000000010010
00000001111111110010
00000111000000010010
00000100000000010010
00000100111111111110
00111100000000000010
00000111111111110010
00000000001000000000
01111111111111111113